NO ./images/NO.xpm
SO ./images/SO.xpm
WE ./images/WE.xpm
EA ./images/EA.xpm

F 233,150,122
C 0,191,122

                1111
111111111111    1001         111111111111   111
100000000001    1001         100000000001111101
100000000001    1001         100000000001   111
100000000001    1001     11111000010000011
11111000000111111001111111000000001100001111111
    100000000000000000000000000000000000000001111111111
    10000010000000N0000000000000000000000000000000000011
    1000000000000000000000000000000000000000000000000011
11111000000000000000000000000000001100000000001111111111
10000000000111111001111111000000000100001111111
100000000001    1001     11111000000000011
100000000001    1001         100000000001
100000000001    1001         100000000001
111111111111    1001         111111111111
                1111
