1111111111111111
11PEC11100000001
1100011100000001
1111111111111111
1000000000000001
1000000000000001
1000000000000001
1000000000000001
1111111111111111
1000000000000001
1111111111111111
