111111111
1EP00001
110010111
111111111
